48 c7 c7 90 50 67 55 c3
00 00 00 00 00 00 00 00
00 00 00 00 00 00 00 00
68 50 67 55 00 00 00 00
64 20 40 00 00 00 00 00
35 66 62 61 62 36 35 36
00
