00 00 00 00 00 00 00 00
00 00 00 00 00 00 00 00
00 00 00 00 00 00 00 00
01 22 40 00 00 00 00 00
2e 21 40 00 00 00 00 00
25 21 40 00 00 00 00 00
48 00 00 00 00 00 00 00
b6 22 40 00 00 00 00 00
d6 21 40 00 00 00 00 00
80 22 40 00 00 00 00 00
71 21 40 00 00 00 00 00
2e 21 40 00 00 00 00 00
64 20 40 00 00 00 00 00
35 66 62 61 62 36 35 36
00
